111111111111111111111111111111111111111
10C11111111100000000000000C00011100E001
10P0000000000001C00000000000000C0000001
111111111111111111111111111111111111111
