1111111111111111111111111111111111111111111111111111111111111111111111
1111100000000000000111000000000000000000000000000000000000000000000001
100000000000000000000000000000C1000000000000000000000000000000E0000001
1000000000000000000000000000000000000000000000000000000000000000000001
100000000000000111100000000000000000000000000000000000000C000000000001
1000000000000000000100C00000000011111111111111111111111111111111111111
100000000011111111111111111111111000000000C001000000000000000000000001
100000000000000000000000000000001000000000111100000000C000000000000001
10000000000000000000000000000000100000000000000000000000000000C0000001
100000000000000000000000000000001000000000C100000000000000000000000001
1000000000000000000000000000000010000000000000000000000000000000000001
100000000000001C100000000000000010000000000000000000000000C00000000001
11110011110000000000000000000000100000C0000000000000000000000000000001
1000000000000000000000000000000010000000000000000000000000000000000001
1000000000000000000000000000000011111111111111111111111111111111100001
1000000000000000000000000000C00000000000000000000000000000000000000001
100000000000000000000000000P000000000000000000000000000000000000000001
1000000000000000000000000000000000000000000000000000000000000000000001
1000000000000000000000000000000000000000000000000000000000000000000001
1000000000000000000000000000000000000000000000000000000000000000000001
1000000000000000000000000000000000000000000000000000000000000000000001
1000000000000000000000000011111111111111100000000000000000000000000001
1000000000000000111111111100000000000000000000111111100000000000000001
11E1111111111111000000000000000000000000000000000000011111111110000001
10000000000000000000000000000000000000000000000000C0000000000000000001
1000000000000000000000000000000000000000000000000000000000000000000001
100000000000000000000000C000000110000000000C00000000000000000000000001
1111111111CC111111111000000000000000000000000000000000CC00000000111111
1111111111111111111111111111111111111111111111111111111111111111111111
