11111111111111111111
10000000011010000011
1001C000110010C00111
11111110000000000001
11110000000011000001
1C100000001111100001
1000E011111111110001
10000000000000000001
11110000011111100011
111C0000000000111001
10000000000000000001
1000000001C100000001
10000000000000000001
10000000000000000C01
11111111000001111111
1C001111100011111111
10000111110111111111
1000C000000000000001
100P000000111C111111
11111111111111111111
